00,09,02,02,02,02,02,02,06,42,21,20,20,23,41,07,02,02,02,02,02,02,02,10,00
00,01,40,43,42,40,40,41,43,40,21,20,20,23,41,40,42,40,40,43,40,40,40,03,00
00,01,40,25,22,22,22,22,22,22,29,20,20,30,22,22,22,22,22,22,22,26,43,03,00
00,01,43,21,20,20,20,20,20,20,20,20,20,20,20,20,20,20,20,20,20,23,40,03,00
00,01,40,21,20,20,20,20,20,20,20,20,20,20,20,20,20,20,20,20,20,23,40,03,00
00,01,43,21,20,20,20,20,20,20,20,20,20,20,20,20,20,20,20,20,20,23,42,03,00
00,01,40,21,20,20,20,20,20,20,20,20,20,20,20,20,20,20,20,20,20,23,41,03,00
00,01,41,21,20,20,20,20,20,20,20,20,20,20,20,20,20,20,20,20,20,23,41,03,00
00,01,40,21,20,20,20,20,20,20,20,20,20,20,20,20,20,20,20,20,20,23,40,03,00
00,01,42,21,20,20,20,20,20,20,20,20,20,20,20,20,20,20,20,20,20,23,40,03,00
00,01,40,21,20,20,20,20,20,20,20,20,20,20,20,20,20,20,20,20,20,23,40,03,00
00,01,41,21,20,20,20,20,20,20,20,20,20,20,20,20,20,20,20,20,20,23,43,03,00
00,01,40,21,20,20,20,20,20,20,20,20,20,20,20,20,20,20,20,20,20,23,43,03,00
00,01,41,21,20,20,20,20,20,20,20,20,20,20,20,20,20,20,20,20,20,23,43,03,00
00,01,40,21,20,20,20,20,20,20,20,20,20,20,20,20,20,20,20,20,20,23,40,03,00
00,01,42,21,20,20,20,20,20,20,20,20,20,20,20,20,20,20,20,20,20,23,40,03,00
00,01,40,21,20,20,20,20,20,20,20,20,20,20,20,20,20,20,20,20,20,23,40,03,00
00,01,43,28,24,24,24,24,24,24,24,24,24,24,24,24,24,24,24,24,24,27,42,03,00
00,01,40,40,40,40,40,40,40,40,43,40,43,42,40,40,41,41,40,41,41,40,41,03,00
00,12,04,04,04,04,04,04,04,04,04,04,04,04,04,04,04,04,04,04,04,04,04,11,00

0,0,0,0,0,0,0,0,0,0,1,0,0,1,0,0,0,0,0,0,0,0,0,0,0
0,0,0,0,0,0,0,0,0,0,1,0,0,1,0,0,0,0,0,0,0,0,0,0,0
0,0,0,0,1,1,1,1,1,1,0,0,0,0,1,1,1,1,1,1,0,0,0,0,0
0,0,0,1,0,0,0,0,0,0,0,0,0,0,0,0,0,0,0,0,1,0,0,0,0
0,0,0,1,0,0,0,0,0,0,0,0,0,0,0,0,0,0,0,0,1,0,0,0,0
0,0,0,1,0,0,0,0,0,0,0,0,0,0,0,0,0,0,0,0,1,0,0,0,0
0,0,0,1,0,0,0,0,0,0,0,0,0,0,0,0,0,0,0,0,1,0,0,0,0
0,0,0,1,0,0,0,0,0,0,0,0,0,0,0,0,0,0,0,0,1,0,0,0,0
0,0,0,1,0,0,0,0,0,0,0,0,0,0,0,0,0,0,0,0,1,0,0,0,0
0,0,0,1,0,0,0,0,0,0,0,0,0,0,0,0,0,0,0,0,1,0,0,0,0
0,0,0,1,0,0,0,0,0,0,0,0,0,0,0,0,0,0,0,0,1,0,0,0,0
0,0,0,1,0,0,0,0,0,0,0,0,0,0,0,0,0,0,0,0,1,0,0,0,0
0,0,0,1,0,0,0,0,0,0,0,0,0,0,0,0,0,0,0,0,1,0,0,0,0
0,0,0,1,0,0,0,0,0,0,0,0,0,0,0,0,0,0,0,0,1,0,0,0,0
0,0,0,1,0,0,0,0,0,0,0,0,0,0,0,0,0,0,0,0,1,0,0,0,0
0,0,0,1,0,0,0,0,0,0,0,0,0,0,0,0,0,0,0,0,1,0,0,0,0
0,0,0,1,0,0,0,0,0,0,0,0,0,0,0,0,0,0,0,0,1,0,0,0,0
0,0,0,0,1,1,1,1,1,1,1,1,1,1,1,1,1,1,1,1,0,0,0,0,0
0,0,0,0,0,0,0,0,0,0,0,0,0,0,0,0,0,0,0,0,0,0,0,0,0
0,0,0,0,0,0,0,0,0,0,0,0,0,0,0,0,0,0,0,0,0,0,0,0,0